// ============================================================
//  FACING TOWERS — two towers, one bridge, deep space — built from scratch
//  (two towers, one bridge, deep space). All geometry + names are
//  Blobcade originals. Generated by scripts/generate-face.mjs.
// ============================================================
@lighting space
@cell 2
@layerstep 4
@killy -22
@gravity 18
@jump 12.5
@speed 9.5

......655555556......
......5##N#N##5......
......5#r###r#5......
......54######5......
......53##F##N5......
......52######5......
......51r###r#5......
......5##N#N##5......
......655###556......
........NMMMN........
........NMMMN........
........NMMMN........
........NMMMN........
........NMMMN........
........NMMMN........
........NMCMN........
........NMMMN........
........NMMMN........
........NMMMN........
.......#NMMMN#.......
......##NMHMN##......
.......#NMMMN#.......
........NMMMN........
........NMMMN........
........NMMMN........
........NMCMN........
........NMMMN........
........NMMMN........
........NMMMN........
.......#NMMMN#.......
......C#NMBMN#C......
.......#NMMMN#.......
........NMMMN........
........NMMMN........
........NMMMN........
........NMCMN........
........NMMMN........
........NMMMN........
........NMMMN........
.......#NMMMN#.......
......##NMHMN##......
.......#NMMMN#.......
........NMMMN........
........NMMMN........
........NMMMN........
........NMCMN........
........NMMMN........
........NMMMN........
........NMMMN........
........NMMMN........
........NMMMN........
........NMMMN........
......655###556......
......5##N#N##5......
......51b###b#5......
......52######5......
......53##f##N5......
......54######5......
......5#b###b#5......
......5##N#N##5......
......655555556......
---
......#########......
......#########......
......#########......
......#.#...#4#......
......#.#...#3#......
......#.#...#2#......
......#.#####1#......
......#########......
......###...###......
.....................
.....................
.....................
.....................
.....................
.....................
.....................
.....................
.....................
.....................
.....................
.....................
.....................
.....................
.....................
.....................
.....................
.....................
.....................
.....................
.....................
.....................
.....................
.....................
.....................
.....................
.....................
.....................
.....................
.....................
.....................
.....................
.....................
.....................
.....................
.....................
.....................
.....................
.....................
.....................
.....................
.....................
.....................
......###...###......
......#########......
......#.#####1#......
......#.#...#2#......
......#.#...#3#......
......#.#...#4#......
......#########......
......#########......
......#########......
---
......#########......
......#########......
......#########......
......#4#####.#......
......#3##.##.#......
......#2#####.#......
......#1#####.#......
......#########......
......###...###......
.....................
.....................
.....................
.....................
.....................
.....................
.....................
.....................
.....................
.....................
.....................
.....................
.....................
.....................
.....................
.....................
.....................
.....................
.....................
.....................
.....................
.....................
.....................
.....................
.....................
.....................
.....................
.....................
.....................
.....................
.....................
.....................
.....................
.....................
.....................
.....................
.....................
.....................
.....................
.....................
.....................
.....................
.....................
......###...###......
......#########......
......#1#####.#......
......#2#####.#......
......#3##.##.#......
......#4#####.#......
......#########......
......#########......
......#########......
---
......1#1#1#1#1......
......#########......
......1#######1......
......#.#######......
......1.##H###1......
......#.#######......
......1.######1......
......#########......
......#########......
.....................
.....................
.....................
.....................
.....................
.....................
.....................
.....................
.....................
.....................
.....................
.....................
.....................
.....................
.....................
.....................
.....................
.....................
.....................
.....................
.....................
.....................
.....................
.....................
.....................
.....................
.....................
.....................
.....................
.....................
.....................
.....................
.....................
.....................
.....................
.....................
.....................
.....................
.....................
.....................
.....................
.....................
.....................
......#########......
......#########......
......1.######1......
......#.#######......
......1.##H###1......
......#.#######......
......1#######1......
......#########......
......1#1#1#1#1......
